Efficiency	the property of society getting the most it can from its scarce resources	false
Equality	the property of distributing economic prosperity uniformly among the members of society	false
Opportunity Cost	whatever must be given up to obtain some item	false
Rational People	people who systematically and purposefully do the best they can to achieve their objectives	false
Marginal Change	a small incremental adjustment to a plan of action	false
Incentive	something that induces a person to act	false
Market Economy	an economy that allocates resources through the decentralized decisions of many firms and house- holds as they interact in markets for goods and services	false
Property Rights	the ability of an individual to own and exercise control over scarce resources	false
market failure	a situation in which a market left on its own fails to allocate resources efficiently	false
externality	the impact of one per- sonâ€™s actions on the well-being of a bystander	false
market power	the ability of a single economic actor (or small group of actors) to have a substantial influence on market prices	false
productivity	the quantity of goods and services produced from each unit of labor input	false
inflation	an increase in the over- all level of prices in the economy	false
production possibilities frontier	a graph that shows the combinations of output that the economy can possibly produce given the available factors of production and the available production technology	false
microeconomics	the study of how households and firms make decisions and how they interact in markets	false
macroeconomics	the study of economywide phenomena, including inflation, unemployment, and economic growth	false
positive statements	claims that attempt to describe the world as it is	false
normative statements	claims that attempt to prescribe how the world should be	false
absolute advantage	the ability to produce a good using fewer inputs than another producer	false
opportunity cost (Ch 3)	whatever must be given up to obtain some item	false
comparative advantage	the ability to produce a good at a lower opportunity cost than another producer	false
imports	goods produced abroad and sold domestically	false
exports	goods produced domestically and sold abroad	false
market	a group of buyers and sellers of a particular good or service	false
competitive market	a market in which there are many buyers and many sellers so that each has a negligible impact on the market price	false
quantity demanded	the amount of a good that buyers are willing and able to purchase	false
law of demand	the claim that, other things being equal, the quantity demanded of a good falls when the price of the good rises	false
demand schedule	a table that shows the relationship between the price of a good and the quantity demanded	false
demand curve	a graph of the relationship between the price of a good and the quantity demanded	false
normal good	a good for which, other things being equal, an increase in income leads to an increase in demand	false
inferior good	a good for which, other things being equal, an increase in income leads to a decrease in demand	false
substitutes	two goods for which an increase in the price of one leads to an increase in the demand for the other	false
complements	two goods for which an increase in the price of one leads to a decrease in the demand for the other	false
quantity supplied	the amount of a good that sellers are willing and able to sell	false
law of supply	the claim that, other things being equal, the quantity supplied of a good rises when the price of the good rises	false
supply schedule	a table that shows the relationship between the price of a good and the quantity supplied	false
supply curve	a graph of the relationship between the price of a good and the quantity supplied	false
equilibrium	a situation in which the market price has reached the level at which quantity supplied equals quantity demanded	false
equilibrium price	the price that balances quantity supplied and quantity demanded	false
equilibrium quantity	the quantity supplied and the quantity demanded at the equilibrium price	false
surplus	a situation in which quantity supplied is greater than quantity demanded	false
shortage	a situation in which quantity demanded is greater than quantity supplied	false
law of supply and demand	the claim that the price of any good adjusts to bring the quantity supplied and the quantity demanded for that good into balance	false
